#          B
# #########
# #       #
# # ####  #
#   #     #
### # #####
A   #
